25 20
#############            
#...........#    ########
#...s...s...######......#
#.......................#
#...........######......#
#.....s.....#    #......#
#.......k...#    #......#
#..%........#    #......#
#####..######    ###..###
    #..#           #..#  
    #..#           #..#  
    #..#         ###..###
  ###..####      #......#
  #..p....#      #......#
  #.......#      #......#
  #.......#      #......#
  #.......#      #......d
  #.......#      #......#
  #.......#      #......#
  #########      ########